{
  "title": "Level 1",
  "difficulty": 1,
  "friction": 1,
  "map": [
    ["1", "-", "-", "-", "-", "-", "-", "-", "-", "-", "2"],
    ["|", ".", ".", ".", ".", ".", ".", ".", ".", ".", "|"],
    ["|", ".", "b", ".", "[", "7", "]", ".", "b", ".", "|"],
    ["|", ".", ".", ".", ".", "_", ".", ".", ".", ".", "|"],
    ["|", ".", "[", "]", ".", ".", ".", "[", "]", ".", "|"],
    ["|", ".", ".", ".", ".", "^", ".", ".", ".", ".", "|"],
    ["|", ".", "b", ".", "[", "+", "]", ".", "b", ".", "|"],
    ["|", ".", ".", ".", ".", "_", ".", ".", ".", ".", "|"],
    ["|", ".", "[", "]", ".", ".", ".", "[", "]", ".", "|"],
    ["|", ".", ".", ".", ".", "^", ".", ".", ".", ".", "|"],
    ["|", ".", "b", ".", "[", "5", "]", ".", "b", ".", "|"],
    ["|", ".", ".", ".", ".", ".", ".", ".", ".", "p", "|"],
    ["4", "-", "-", "-", "-", "-", "-", "-", "-", "-", "3"]
  ]
}
