{
  "name": "1",
  "friction": 0.75,
  "gravity": 7,
  "airResistance": 4,
  "map": [
        [" ", " ", " ", " ", " ", " ", " ", " ", " ", " ", " ", " ", " ", " ", " ", "_", " ", " ", " ", " ", " ", " ", "_"],
        [" ", " ", " ", " ", " ", " ", " ", " ", " ", " ", " ", " ", " ", " ", " ", " ", " ", " ", " ", " ", " ", " ", "_"],
        [" ", " ", " ", " ", " ", " ", " ", " ", " ", " ", " ", " ", " ", " ", " ", " ", " ", " ", " ", " ", " ", " ", "_"],
        [" ", " ", " ", "_", " ", " ", " ", " ", " ", " ", " ", "_", "_", " ", " ", " ", " ", " ", " ", " ", " ", " ", "_"],
        [" ", " ", " ", " ", " ", " ", " ", " ", " ", " ", " ", " ", " ", " ", " ", " ", " ", " ", " ", " ", " ", " ", "_"],
        ["_", "_", "_", "_", "_", "_", "_", " ", "_", "_", " ", "_", "_", "_", "_", "_", "_", "_", "_", "_", "_", "_", "_"],
        ["8", "8", "8", "1", "8", "8", "8", "8", "8", "8", "8", "8", "8", "8", "8", "8", "8", "8", "8", "8", "8", "8", "8"]
    ]
}
