{
  "name": "1",
  "friction": 0.75,
  "gravity": 7,
  "airResistance": 5,
  "map": [
        [" ", " ", " ", "_", " ", " ", " ", " ", " ", " ", "o", " ", " ", " ", " ", " ", " ", " ", " ", " ", " ", " ", " ", " ", " ", " ", " ", " ", " ", " ", " ", " ", " ", " ", " ", " ", " ", " ", " ", " ", " ", " ", " ", " ", " ", " ", " ", " ", " ", " ", " ", " ", " ", " ", " ", " ", " ", " "],
        [" ", " ", " ", "_", " ", " ", " ", " ", " ", "*", "*", "*", " ", " ", " ", " ", " ", " ", " ", " ", " ", " ", " ", "o", " ", " ", " ", " ", " ", " ", " ", " ", " ", " ", " ", " ", " ", " ", " ", " ", " ", " ", " ", " ", " ", " ", " ", " ", " ", " ", " ", " ", " ", " ", " ", " ", " ", " "],
        [" ", " ", " ", "_", " ", " ", " ", " ", " ", "*", "*", "*", " ", " ", " ", " ", " ", " ", " ", " ", " ", " ", "_", "_", " ", " ", "_", "_", " ", " ", " ", "#", "#", "#", "#", " ", " ", " ", " ", " ", " ", " ", " ", " ", " ", " ", " ", " ", " ", " ", " ", " ", " ", " ", " ", " ", " ", " "],
        [" ", " ", " ", "_", " ", " ", "#", " ", "*", "*", " ", "*", "*", " ", " ", " ", " ", " ", " ", " ", " ", " ", " ", " ", " ", " ", " ", " ", " ", " ", " ", " ", " ", " ", " ", " ", " ", " ", " ", " ", " ", " ", " ", " ", " ", " ", " ", " ", " ", " ", " ", " ", " ", " ", " ", " ", " ", " "],
        [" ", " ", " ", "_", " ", " ", "#", " ", "_", "_", "_", "_", "_", " ", " ", " ", " ", " ", " ", " ", " ", "_", " ", " ", " ", " ", " ", "#", " ", "_", " ", " ", " ", " ", " ", " ", " ", " ", " ", " ", " ", " ", " ", " ", " ", " ", " ", " ", " ", " ", " ", " ", " ", " ", " ", " ", " ", " "],
        [" ", " ", "o", "_", " ", " ", "#", "o", " ", " ", " ", " ", "o", "o", "o", "*", "*", "o", "*", "*", "o", " ", " ", " ", " ", " ", " ", "#", "o", " ", " ", " ", " ", " ", " ", "o", "o", " ", ">", " ", " ", " ", " ", " ", " ", " ", " ", " ", " ", " ", " ", " ", " ", " ", " ", " ", " ", " "],
        ["_", "_", "_", "_", "_", "_", "_", "_", "_", "_", "_", " ", "_", "_", "_", "_", "_", "_", " ", "_", "_", "_", "_", " ", " ", "_", "_", "_", "_", "_", "_", "_", "_", "_", "_", "_", "_", "_", "_", "_", "_", "_", "_", "_", "_", "_", "_", "_", "_", "_", "_", "_", "_", "_", "_", "_", "_", "_"],
        ["2", "1", "1", "1", "1", "1", "2", "2", "1", "1", "1", "1", "1", "1", "4", "8", "8", "1", "1", "1", "2", "2", "2", "1", "1", "1", "2", "1", "2", "2", "2", "1", "1", "1", "1", "1", "8", "8", "8", "8", "8", "8", "8", "8", "8", "8", "8", "8", "8", "8", "8", "8", "8", "8", "8", "8", "8", "8"]
    ]
}
